//MAP CONVERTED BY dmm2tgm.py THIS HEADER COMMENT PREVENTS RECONVERSION, DO NOT REMOVE
"ez" = (
/obj/structure/barricade/solid/plasteel,
/obj/effect/mapping_helpers/barricade/wired,
/obj/effect/mapping_helpers/barricade/melee,
/turf/open/floor/plating/ground/dirt,
/area/deathmatch)
"eX" = (
/obj/structure/barricade/solid/plasteel{
	dir = 8
	},
/obj/structure/barricade/solid/plasteel,
/obj/effect/mapping_helpers/barricade/wired,
/obj/effect/mapping_helpers/barricade/melee,
/turf/open/floor/plating/ground/dirt,
/area/deathmatch)
"hH" = (
/obj/effect/ai_node,
/turf/open/floor/plating/ground/dirt,
/area/deathmatch)
"jH" = (
/obj/structure/barricade/solid/plasteel{
	dir = 1
	},
/obj/structure/barricade/solid/plasteel{
	dir = 4
	},
/obj/effect/mapping_helpers/barricade/wired,
/obj/effect/mapping_helpers/barricade/melee,
/turf/open/floor/plating/ground/dirt,
/area/deathmatch)
"kE" = (
/obj/effect/ai_node,
/obj/structure/barricade/folding,
/obj/effect/mapping_helpers/barricade/wired,
/turf/open/floor/plating/ground/dirt,
/area/deathmatch)
"lq" = (
/obj/item/stack/sheet/metal/large_stack,
/turf/open/floor/plating/ground/dirt,
/area/deathmatch)
"lI" = (
/obj/item/stack/sandbags/large_stack,
/turf/open/floor/plating/ground/dirt,
/area/deathmatch)
"qZ" = (
/obj/structure/barricade/solid/plasteel{
	dir = 1
	},
/obj/effect/mapping_helpers/barricade/wired,
/obj/effect/mapping_helpers/barricade/melee,
/turf/open/floor/plating/ground/dirt,
/area/deathmatch)
"zg" = (
/obj/structure/desertdam/decals/loose_sand_overlay/alt,
/turf/open/floor/plating/ground/dirt,
/area/deathmatch)
"BI" = (
/obj/structure/barricade/solid/plasteel,
/obj/effect/mapping_helpers/barricade/melee,
/obj/effect/mapping_helpers/barricade/wired,
/turf/open/floor/plating/ground/dirt,
/area/deathmatch)
"BV" = (
/obj/structure/barricade/folding{
	dir = 4
	},
/obj/effect/mapping_helpers/barricade/wired,
/turf/open/floor/plating/ground/dirt,
/area/deathmatch)
"DV" = (
/obj/effect/landmark/weapon_spawn/tier3_weapon_spawn,
/turf/open/floor/plating/ground/dirt,
/area/deathmatch)
"FE" = (
/turf/open/floor/plating/ground/dirt,
/area/deathmatch)
"Ht" = (
/obj/structure/barricade/folding{
	dir = 1
	},
/obj/effect/mapping_helpers/barricade/wired,
/turf/open/floor/plating/ground/dirt,
/area/deathmatch)
"HM" = (
/obj/item/stack/barbed_wire/full,
/obj/effect/ai_node,
/turf/open/floor/plating/ground/dirt,
/area/deathmatch)
"Ii" = (
/obj/effect/landmark/deathmatch,
/turf/open/floor/plating/ground/dirt,
/area/deathmatch)
"IH" = (
/obj/structure/barricade/folding,
/obj/effect/mapping_helpers/barricade/wired,
/turf/open/floor/plating/ground/dirt,
/area/deathmatch)
"Jg" = (
/obj/structure/barricade/folding{
	dir = 8
	},
/obj/effect/mapping_helpers/barricade/wired,
/turf/open/floor/plating/ground/dirt,
/area/deathmatch)
"Ji" = (
/obj/item/stack/barbed_wire/full,
/turf/open/floor/plating/ground/dirt,
/area/deathmatch)
"MP" = (
/turf/closed/mineral/smooth/desertdamrockwall/indestructible,
/area/deathmatch)
"Ng" = (
/obj/structure/barricade/solid/plasteel{
	dir = 4
	},
/obj/effect/mapping_helpers/barricade/wired,
/obj/effect/mapping_helpers/barricade/melee,
/turf/open/floor/plating/ground/dirt,
/area/deathmatch)
"Si" = (
/obj/effect/landmark/weapon_spawn/tier1_weapon_spawn,
/turf/open/floor/plating/ground/dirt,
/area/deathmatch)
"Uq" = (
/obj/structure/barricade/solid/plasteel{
	dir = 8
	},
/obj/effect/mapping_helpers/barricade/wired,
/obj/effect/mapping_helpers/barricade/melee,
/turf/open/floor/plating/ground/dirt,
/area/deathmatch)
"XP" = (
/obj/item/stack/sheet/metal/large_stack,
/obj/effect/ai_node,
/turf/open/floor/plating/ground/dirt,
/area/deathmatch)
"YD" = (
/turf/closed/wall/desert,
/area/deathmatch)
"ZW" = (
/obj/effect/landmark/weapon_spawn/tier2_weapon_spawn,
/turf/open/floor/plating/ground/dirt,
/area/deathmatch)

(1,1,1) = {"
MP
MP
MP
MP
MP
MP
MP
MP
MP
MP
MP
MP
MP
MP
MP
MP
MP
MP
MP
MP
MP
MP
MP
MP
MP
MP
MP
MP
MP
MP
MP
MP
MP
MP
MP
MP
MP
MP
MP
MP
MP
MP
MP
MP
MP
MP
"}
(2,1,1) = {"
MP
Ii
Si
FE
BI
FE
BI
YD
FE
FE
FE
FE
YD
qZ
FE
qZ
hH
Si
Ii
hH
Ii
Si
hH
BI
FE
BI
YD
FE
FE
FE
FE
YD
qZ
FE
qZ
hH
Si
Ii
hH
FE
FE
hH
FE
Si
Ii
MP
"}
(3,1,1) = {"
MP
FE
ZW
FE
BI
FE
BI
YD
FE
FE
FE
FE
YD
qZ
FE
qZ
FE
ZW
FE
MP
FE
ZW
FE
BI
FE
BI
YD
FE
FE
FE
FE
YD
qZ
FE
qZ
FE
ZW
FE
MP
FE
FE
FE
FE
ZW
FE
MP
"}
(4,1,1) = {"
MP
hH
DV
FE
kE
FE
IH
FE
FE
FE
FE
FE
zg
Ht
FE
Ht
hH
DV
FE
MP
FE
DV
hH
kE
FE
IH
FE
FE
FE
FE
FE
zg
Ht
FE
Ht
hH
DV
FE
MP
FE
FE
FE
FE
DV
FE
MP
"}
(5,1,1) = {"
MP
FE
FE
FE
BI
FE
BI
FE
FE
FE
Ji
FE
FE
qZ
FE
qZ
FE
FE
FE
MP
FE
FE
FE
BI
FE
BI
FE
FE
FE
Ji
FE
FE
qZ
FE
qZ
FE
FE
FE
MP
Ng
Ng
BV
BV
Ng
Ng
MP
"}
(6,1,1) = {"
MP
FE
FE
FE
BI
FE
BI
FE
FE
FE
lI
FE
FE
qZ
FE
qZ
FE
FE
FE
MP
FE
FE
FE
BI
FE
BI
FE
FE
FE
lI
FE
FE
qZ
FE
qZ
FE
FE
FE
MP
FE
FE
FE
FE
FE
FE
MP
"}
(7,1,1) = {"
MP
FE
FE
FE
IH
FE
IH
FE
FE
FE
FE
FE
FE
Ht
FE
Ht
FE
FE
FE
MP
FE
FE
FE
IH
FE
IH
FE
FE
FE
FE
FE
FE
Ht
FE
Ht
FE
FE
FE
MP
Ng
Ng
BV
BV
Ng
Ng
MP
"}
(8,1,1) = {"
MP
FE
FE
FE
BI
FE
BI
YD
FE
FE
FE
FE
YD
qZ
FE
qZ
FE
FE
FE
MP
FE
FE
FE
BI
FE
BI
YD
FE
FE
FE
FE
YD
qZ
FE
qZ
FE
FE
FE
MP
YD
FE
FE
FE
FE
YD
MP
"}
(9,1,1) = {"
MP
FE
FE
FE
BI
FE
BI
YD
FE
FE
FE
FE
YD
qZ
FE
qZ
FE
FE
FE
MP
FE
FE
FE
BI
FE
BI
YD
FE
FE
FE
FE
YD
qZ
FE
qZ
FE
FE
FE
MP
FE
FE
FE
FE
FE
FE
MP
"}
(10,1,1) = {"
MP
hH
MP
MP
MP
MP
MP
MP
MP
MP
MP
MP
MP
MP
MP
MP
MP
MP
MP
MP
MP
MP
MP
MP
MP
MP
MP
MP
MP
MP
MP
MP
MP
MP
MP
MP
MP
MP
MP
FE
FE
FE
FE
FE
FE
MP
"}
(11,1,1) = {"
MP
Ii
Si
FE
BI
FE
BI
YD
FE
FE
FE
FE
YD
qZ
FE
qZ
hH
Si
Ii
hH
Ii
Si
hH
BI
FE
BI
YD
FE
FE
FE
FE
YD
qZ
FE
qZ
FE
Si
Ii
MP
FE
FE
Ji
lI
FE
FE
MP
"}
(12,1,1) = {"
MP
FE
ZW
FE
BI
FE
BI
YD
FE
FE
FE
FE
YD
qZ
FE
qZ
FE
ZW
FE
MP
FE
ZW
FE
BI
FE
BI
YD
FE
FE
FE
FE
YD
qZ
FE
qZ
FE
ZW
FE
MP
FE
FE
FE
FE
FE
FE
MP
"}
(13,1,1) = {"
MP
hH
DV
FE
kE
FE
IH
FE
FE
FE
FE
FE
zg
Ht
FE
Ht
hH
DV
FE
MP
FE
DV
hH
kE
FE
IH
FE
FE
FE
FE
FE
zg
Ht
FE
Ht
hH
DV
hH
MP
YD
FE
FE
FE
FE
YD
MP
"}
(14,1,1) = {"
MP
FE
FE
FE
BI
FE
BI
FE
FE
FE
Ji
FE
FE
qZ
FE
qZ
FE
FE
FE
MP
FE
FE
FE
BI
FE
BI
FE
FE
FE
Ji
FE
FE
qZ
FE
qZ
FE
FE
FE
MP
Uq
Uq
Jg
Jg
Uq
Uq
MP
"}
(15,1,1) = {"
MP
FE
FE
FE
BI
FE
BI
FE
FE
FE
lI
FE
FE
qZ
FE
qZ
FE
FE
FE
MP
FE
FE
FE
BI
FE
BI
FE
FE
FE
lI
FE
FE
qZ
FE
qZ
FE
FE
FE
MP
FE
FE
FE
FE
FE
FE
MP
"}
(16,1,1) = {"
MP
FE
FE
FE
IH
FE
IH
FE
FE
FE
FE
FE
FE
Ht
FE
Ht
FE
FE
FE
MP
FE
FE
FE
IH
FE
IH
FE
FE
FE
FE
FE
FE
Ht
FE
Ht
FE
FE
FE
MP
Uq
Uq
Jg
Jg
Uq
Uq
MP
"}
(17,1,1) = {"
MP
FE
FE
FE
BI
FE
BI
YD
FE
FE
FE
FE
YD
qZ
FE
qZ
FE
FE
FE
MP
FE
FE
FE
BI
FE
BI
YD
FE
FE
FE
FE
YD
qZ
FE
qZ
FE
FE
FE
MP
Si
Ii
hH
FE
FE
hH
MP
"}
(18,1,1) = {"
MP
FE
FE
FE
BI
FE
BI
YD
FE
FE
FE
FE
YD
qZ
FE
qZ
FE
FE
FE
MP
FE
FE
FE
BI
FE
BI
YD
FE
FE
FE
FE
YD
qZ
FE
qZ
FE
FE
FE
MP
ZW
FE
FE
FE
FE
FE
MP
"}
(19,1,1) = {"
MP
MP
MP
MP
MP
MP
MP
MP
MP
MP
MP
MP
MP
MP
MP
MP
MP
MP
MP
MP
MP
MP
MP
MP
MP
MP
MP
MP
MP
MP
MP
MP
MP
MP
MP
MP
MP
hH
MP
DV
FE
FE
FE
FE
FE
MP
"}
(20,1,1) = {"
MP
Ii
Si
FE
BI
FE
BI
YD
FE
FE
FE
FE
YD
qZ
FE
qZ
hH
Si
Ii
hH
Ii
Si
hH
BI
FE
BI
YD
FE
FE
FE
FE
YD
qZ
FE
qZ
FE
Si
Ii
MP
MP
MP
MP
MP
MP
FE
MP
"}
(21,1,1) = {"
MP
FE
ZW
FE
BI
FE
BI
YD
FE
FE
FE
FE
YD
qZ
FE
qZ
FE
ZW
FE
MP
FE
ZW
FE
BI
FE
BI
YD
FE
FE
FE
FE
YD
qZ
FE
qZ
FE
ZW
FE
MP
Si
Ii
hH
FE
FE
hH
MP
"}
(22,1,1) = {"
MP
hH
DV
FE
kE
FE
IH
FE
FE
FE
FE
FE
zg
Ht
FE
Ht
hH
DV
FE
MP
FE
DV
hH
IH
FE
IH
FE
FE
FE
FE
FE
zg
Ht
FE
Ht
hH
DV
hH
MP
ZW
FE
FE
FE
FE
FE
MP
"}
(23,1,1) = {"
MP
FE
FE
FE
BI
FE
BI
FE
FE
FE
Ji
FE
FE
qZ
FE
qZ
FE
FE
FE
MP
FE
FE
FE
BI
FE
BI
FE
FE
FE
Ji
FE
FE
qZ
FE
qZ
FE
FE
FE
MP
DV
FE
FE
FE
FE
FE
MP
"}
(24,1,1) = {"
MP
FE
FE
FE
BI
FE
BI
FE
FE
FE
lI
FE
FE
qZ
FE
qZ
FE
FE
FE
MP
FE
FE
FE
BI
FE
BI
FE
FE
FE
lI
FE
FE
qZ
FE
qZ
FE
FE
FE
MP
Ng
Ng
BV
BV
Ng
Ng
MP
"}
(25,1,1) = {"
MP
FE
FE
FE
IH
FE
IH
FE
FE
FE
FE
FE
FE
Ht
FE
Ht
FE
FE
FE
MP
FE
FE
FE
IH
FE
IH
FE
FE
FE
FE
FE
FE
Ht
FE
Ht
FE
FE
FE
MP
FE
FE
FE
FE
FE
FE
MP
"}
(26,1,1) = {"
MP
FE
FE
FE
BI
FE
BI
YD
FE
FE
FE
FE
YD
qZ
FE
qZ
FE
FE
FE
MP
FE
FE
FE
BI
FE
BI
YD
FE
FE
FE
FE
YD
qZ
FE
qZ
FE
FE
FE
MP
Ng
Ng
BV
BV
Ng
Ng
MP
"}
(27,1,1) = {"
MP
FE
FE
FE
BI
FE
BI
YD
FE
FE
FE
FE
YD
qZ
FE
qZ
FE
FE
FE
MP
FE
FE
FE
BI
FE
BI
YD
FE
FE
FE
FE
YD
qZ
FE
qZ
FE
FE
FE
MP
YD
FE
FE
FE
FE
YD
MP
"}
(28,1,1) = {"
MP
hH
MP
MP
MP
MP
MP
MP
MP
MP
MP
MP
MP
MP
MP
MP
MP
MP
MP
MP
MP
MP
MP
MP
MP
MP
MP
MP
MP
MP
MP
MP
MP
MP
MP
MP
MP
MP
MP
FE
FE
FE
FE
FE
FE
MP
"}
(29,1,1) = {"
MP
Ii
Si
FE
BI
FE
BI
YD
FE
FE
FE
FE
YD
qZ
FE
qZ
hH
Si
Ii
hH
Ii
Si
hH
BI
FE
BI
YD
FE
FE
FE
FE
YD
qZ
FE
qZ
FE
Si
Ii
MP
FE
FE
FE
FE
FE
FE
MP
"}
(30,1,1) = {"
MP
FE
ZW
FE
BI
FE
BI
YD
FE
FE
FE
FE
YD
qZ
FE
qZ
FE
ZW
FE
MP
FE
ZW
FE
BI
FE
BI
YD
FE
FE
FE
FE
YD
qZ
FE
qZ
FE
ZW
FE
MP
FE
FE
Ji
lI
FE
FE
MP
"}
(31,1,1) = {"
MP
hH
DV
FE
kE
FE
IH
FE
FE
FE
FE
FE
zg
Ht
FE
Ht
hH
DV
FE
MP
FE
DV
hH
kE
FE
IH
FE
FE
FE
FE
FE
zg
Ht
FE
Ht
hH
DV
hH
MP
FE
FE
FE
FE
FE
FE
MP
"}
(32,1,1) = {"
MP
FE
FE
FE
BI
FE
BI
FE
FE
FE
Ji
FE
FE
qZ
FE
qZ
FE
FE
FE
MP
FE
FE
FE
BI
FE
BI
FE
FE
FE
Ji
FE
FE
qZ
FE
qZ
FE
FE
FE
MP
YD
FE
FE
FE
FE
YD
MP
"}
(33,1,1) = {"
MP
FE
FE
FE
BI
FE
BI
FE
FE
FE
lI
FE
FE
qZ
FE
qZ
FE
FE
FE
MP
FE
FE
FE
BI
FE
BI
FE
FE
FE
lI
FE
FE
qZ
FE
qZ
FE
FE
FE
MP
Uq
Uq
Jg
Jg
Uq
Uq
MP
"}
(34,1,1) = {"
MP
FE
FE
FE
IH
FE
IH
FE
FE
FE
FE
FE
FE
Ht
FE
Ht
FE
FE
FE
MP
FE
FE
FE
IH
FE
IH
FE
FE
FE
FE
FE
FE
Ht
FE
Ht
FE
FE
FE
MP
FE
FE
FE
FE
FE
FE
MP
"}
(35,1,1) = {"
MP
FE
FE
FE
BI
FE
BI
YD
FE
FE
FE
FE
YD
qZ
FE
qZ
FE
FE
FE
MP
FE
FE
FE
BI
FE
BI
YD
FE
FE
FE
FE
YD
qZ
FE
qZ
FE
FE
FE
MP
Uq
Uq
Jg
Jg
Uq
Uq
MP
"}
(36,1,1) = {"
MP
FE
FE
FE
BI
FE
BI
YD
FE
FE
FE
FE
YD
qZ
FE
qZ
FE
FE
FE
MP
FE
FE
FE
BI
FE
BI
YD
FE
FE
FE
FE
YD
qZ
FE
qZ
FE
FE
FE
MP
Si
Ii
hH
FE
FE
hH
MP
"}
(37,1,1) = {"
MP
MP
MP
MP
MP
MP
MP
MP
MP
MP
MP
MP
MP
MP
MP
MP
MP
MP
MP
MP
MP
MP
MP
MP
MP
MP
MP
MP
MP
MP
MP
MP
MP
MP
MP
MP
MP
hH
MP
ZW
DV
FE
FE
FE
FE
MP
"}
(38,1,1) = {"
MP
Ii
Si
FE
BI
FE
BI
YD
FE
FE
FE
FE
YD
qZ
FE
qZ
hH
Si
Ii
hH
Ii
Si
hH
BI
FE
BI
YD
FE
FE
FE
FE
YD
qZ
FE
qZ
FE
Si
Ii
MP
lq
Ji
lI
FE
FE
FE
MP
"}
(39,1,1) = {"
MP
FE
ZW
FE
BI
FE
BI
YD
FE
FE
FE
FE
YD
qZ
FE
qZ
FE
ZW
FE
MP
FE
ZW
FE
BI
FE
BI
YD
FE
FE
FE
FE
YD
qZ
FE
qZ
FE
ZW
FE
MP
MP
MP
MP
MP
MP
HM
MP
"}
(40,1,1) = {"
MP
hH
DV
FE
kE
FE
IH
FE
FE
FE
FE
FE
zg
Ht
FE
Ht
hH
DV
FE
MP
FE
DV
hH
kE
FE
IH
FE
FE
FE
FE
FE
zg
Ht
FE
Ht
hH
DV
hH
MP
hH
FE
FE
Ht
FE
lq
MP
"}
(41,1,1) = {"
MP
FE
FE
FE
BI
FE
BI
FE
FE
FE
Ji
FE
FE
qZ
FE
qZ
FE
FE
FE
MP
FE
FE
FE
BI
FE
BI
FE
FE
FE
Ji
FE
FE
qZ
FE
qZ
FE
FE
FE
MP
FE
FE
FE
qZ
FE
FE
MP
"}
(42,1,1) = {"
MP
FE
FE
FE
BI
FE
BI
FE
FE
FE
lI
FE
FE
qZ
FE
qZ
FE
FE
FE
MP
FE
FE
FE
BI
FE
BI
FE
FE
FE
lI
FE
FE
qZ
FE
qZ
FE
FE
lI
MP
FE
FE
FE
jH
Ng
BV
MP
"}
(43,1,1) = {"
MP
FE
FE
FE
IH
FE
IH
FE
FE
FE
FE
FE
FE
Ht
FE
Ht
FE
FE
FE
MP
FE
FE
FE
IH
FE
IH
FE
FE
FE
FE
FE
FE
Ht
FE
Ht
FE
FE
lq
MP
Jg
Uq
eX
FE
FE
FE
MP
"}
(44,1,1) = {"
MP
FE
FE
FE
BI
FE
BI
YD
FE
FE
FE
FE
YD
qZ
FE
qZ
FE
FE
FE
MP
FE
FE
FE
BI
FE
BI
YD
FE
FE
FE
FE
YD
qZ
FE
qZ
FE
FE
Ji
MP
FE
FE
ez
FE
FE
FE
MP
"}
(45,1,1) = {"
MP
FE
FE
FE
BI
FE
BI
YD
FE
FE
FE
FE
YD
qZ
FE
qZ
FE
FE
FE
MP
FE
FE
FE
BI
FE
BI
YD
FE
FE
FE
FE
YD
qZ
FE
qZ
FE
FE
HM
hH
XP
FE
IH
FE
FE
hH
MP
"}
(46,1,1) = {"
MP
MP
MP
MP
MP
MP
MP
MP
MP
MP
MP
MP
MP
MP
MP
MP
MP
MP
MP
MP
MP
MP
MP
MP
MP
MP
MP
MP
MP
MP
MP
MP
MP
MP
MP
MP
MP
MP
MP
MP
MP
MP
MP
MP
MP
MP
"}
