//MAP CONVERTED BY dmm2tgm.py THIS HEADER COMMENT PREVENTS RECONVERSION, DO NOT REMOVE
"aZ" = (
/obj/structure/prop/urban/misc/fake/heavydutywire/heavy2,
/obj/structure/barricade/solid/plasteel{
	dir = 4
	},
/obj/effect/mapping_helpers/barricade/melee,
/turf/open/floor/plating/ground/concrete,
/area/deathmatch)
"bL" = (
/obj/structure/prop/urban/misc/fake/heavydutywire/heavy2,
/obj/structure/prop/urban/signs/high_voltage,
/turf/open/floor/plating/ground/concrete,
/area/deathmatch)
"ez" = (
/turf/open/floor/plating/ground/concrete,
/area/deathmatch)
"eX" = (
/obj/structure/prop/urban/misc/fake/heavydutywire/heavy2,
/turf/open/floor/plating/ground/concrete,
/area/deathmatch)
"hH" = (
/obj/item/weapon/gun/standard_minigun/nest{
	dir = 1
	},
/turf/open/floor/plating/ground/drought/cave/deep,
/area/deathmatch)
"ib" = (
/obj/structure/prop/urban/misc/fake/heavydutywire/heavy3{
	dir = 8
	},
/turf/open/floor/plating/ground/concrete,
/area/deathmatch)
"iD" = (
/obj/structure/prop/urban/fakeplatforms/rockplatform{
	dir = 4
	},
/turf/open/liquid/lava,
/area/deathmatch)
"jH" = (
/obj/effect/ai_node,
/turf/open/floor/plating/ground/drought/cave/deep,
/area/deathmatch)
"kW" = (
/turf/open/liquid/lava,
/area/deathmatch)
"lq" = (
/turf/closed/mineral/smooth/lavawall/indestructible,
/area/deathmatch)
"lI" = (
/obj/structure/barricade/solid/plasteel{
	dir = 4
	},
/obj/effect/mapping_helpers/barricade/melee,
/turf/open/floor/box,
/area/deathmatch)
"lN" = (
/obj/structure/prop/urban/misc/fake/heavydutywire/heavy2,
/obj/structure/barricade/solid/plasteel{
	dir = 8
	},
/obj/effect/mapping_helpers/barricade/melee,
/turf/open/floor/plating/ground/concrete,
/area/deathmatch)
"mF" = (
/obj/structure/barricade/solid/plasteel{
	dir = 1
	},
/obj/effect/mapping_helpers/barricade/melee,
/turf/open/floor/plating/ground/drought/cave/deep,
/area/deathmatch)
"np" = (
/obj/structure/prop/urban/misc/fake/heavydutywire/heavy3{
	dir = 4
	},
/turf/open/floor/plating/ground/concrete,
/area/deathmatch)
"qZ" = (
/turf/open/floor/box,
/area/deathmatch)
"rL" = (
/turf/closed/wall/hangar,
/area/deathmatch)
"sq" = (
/obj/machinery/vending/MarineMed,
/turf/open/floor/carpet/black,
/area/deathmatch)
"sC" = (
/obj/structure/prop/urban/factory/robotic_arm/flipped,
/obj/structure/prop/urban/misc/fake/heavydutywire/heavy3{
	dir = 1
	},
/turf/open/floor/plating/ground/concrete,
/area/deathmatch)
"uF" = (
/obj/structure/prop/urban/vehicles/large/suv/suv_6,
/turf/open/floor/box,
/area/deathmatch)
"vT" = (
/obj/machinery/vending/armor_supply,
/turf/open/floor/carpet/black,
/area/deathmatch)
"wi" = (
/obj/structure/barricade/solid/plasteel,
/obj/effect/mapping_helpers/barricade/melee,
/turf/open/floor/plating/ground/drought/cave/deep,
/area/deathmatch)
"wE" = (
/obj/structure/prop/urban/fakeplatforms/rockplatform,
/obj/structure/prop/urban/fakeplatforms/rockplatform{
	dir = 1
	},
/turf/open/liquid/lava,
/area/deathmatch)
"wM" = (
/obj/structure/barricade/solid/plasteel{
	dir = 8
	},
/obj/effect/mapping_helpers/barricade/melee,
/turf/open/floor/plating/ground/concrete,
/area/deathmatch)
"xY" = (
/obj/structure/prop/urban/fakeplatforms/rockplatform{
	dir = 4
	},
/turf/open/floor/urban/metal/grated,
/area/deathmatch)
"zg" = (
/turf/open/floor/plating/ground/drought/cave/deep,
/area/deathmatch)
"zk" = (
/obj/structure/prop/urban/vehicles/large/suv/suv_5,
/turf/open/floor/box,
/area/deathmatch)
"BI" = (
/obj/machinery/loadout_vendor,
/turf/open/floor/carpet/black,
/area/deathmatch)
"BV" = (
/obj/item/tool/pickaxe/plasmacutter,
/turf/open/floor/plating/ground/drought/cave/deep,
/area/deathmatch)
"BX" = (
/obj/structure/prop/urban/vehicles/large/suv/suv_8,
/turf/open/floor/box,
/area/deathmatch)
"CB" = (
/obj/machinery/quick_vendor/civil_war,
/turf/open/floor/carpet/black,
/area/deathmatch)
"DV" = (
/obj/effect/landmark/deathmatch,
/turf/open/floor/plating/ground/drought/cave/deep,
/area/deathmatch)
"Eo" = (
/obj/structure/prop/urban/fakeplatforms/rockplatform,
/obj/structure/prop/urban/fakeplatforms/rockplatform{
	dir = 8
	},
/turf/open/liquid/lava,
/area/deathmatch)
"Eq" = (
/obj/structure/barricade/solid/plasteel{
	dir = 4
	},
/obj/effect/mapping_helpers/barricade/melee,
/turf/open/floor/plating/ground/concrete,
/area/deathmatch)
"Fj" = (
/obj/structure/prop/urban/fakeplatforms/rockplatform{
	dir = 8
	},
/turf/open/floor/urban/metal/grated,
/area/deathmatch)
"FE" = (
/obj/structure/prop/urban/misc/fake/heavydutywire/heavy2,
/obj/effect/landmark/deathmatch,
/turf/open/floor/plating/ground/concrete,
/area/deathmatch)
"GX" = (
/obj/item/weapon/gun/standard_minigun/nest,
/turf/open/floor/plating/ground/drought/cave/deep,
/area/deathmatch)
"GY" = (
/obj/structure/prop/urban/vehicles/large/suv/suv_7,
/turf/open/floor/box,
/area/deathmatch)
"Ht" = (
/obj/structure/prop/urban/fakeplatforms/rockplatform{
	dir = 1
	},
/turf/open/liquid/lava,
/area/deathmatch)
"HM" = (
/obj/structure/prop/urban/fakeplatforms/rockplatform{
	dir = 8
	},
/turf/open/liquid/lava,
/area/deathmatch)
"Ii" = (
/obj/structure/barricade/solid/plasteel{
	dir = 8
	},
/obj/effect/mapping_helpers/barricade/melee,
/turf/open/floor/box,
/area/deathmatch)
"IH" = (
/turf/closed/mineral/smooth/lavawall,
/area/deathmatch)
"Jg" = (
/obj/effect/ai_node,
/turf/open/floor/box,
/area/deathmatch)
"Km" = (
/turf/open/floor/carpet/black,
/area/deathmatch)
"KT" = (
/obj/structure/prop/urban/factory/robotic_arm,
/obj/structure/prop/urban/misc/fake/heavydutywire/heavy1{
	dir = 4
	},
/turf/open/floor/plating/ground/concrete,
/area/deathmatch)
"LD" = (
/obj/structure/prop/urban/fakeplatforms/rockplatform,
/obj/structure/prop/urban/fakeplatforms/rockplatform{
	dir = 4
	},
/turf/open/liquid/lava,
/area/deathmatch)
"Ng" = (
/obj/effect/landmark/deathmatch,
/turf/open/floor/plating/ground/concrete,
/area/deathmatch)
"Or" = (
/obj/structure/prop/urban/fakeplatforms/rockplatform{
	dir = 1
	},
/obj/structure/prop/urban/fakeplatforms/rockplatform{
	dir = 4
	},
/turf/open/liquid/lava,
/area/deathmatch)
"Ox" = (
/obj/structure/prop/urban/fakeplatforms/rockplatform,
/turf/open/liquid/lava,
/area/deathmatch)
"Pr" = (
/obj/structure/prop/urban/misc/fake/heavydutywire/heavy3,
/turf/open/floor/plating/ground/concrete,
/area/deathmatch)
"Qd" = (
/obj/structure/prop/urban/vehicles/large/suv/suv_1,
/turf/open/floor/box,
/area/deathmatch)
"Si" = (
/obj/item/stack/sheet/plasteel/large_stack,
/turf/open/floor/plating/ground/drought/cave/deep,
/area/deathmatch)
"SX" = (
/obj/structure/prop/urban/fakeplatforms/rockplatform{
	dir = 1
	},
/obj/structure/prop/urban/fakeplatforms/rockplatform{
	dir = 8
	},
/turf/open/liquid/lava,
/area/deathmatch)
"Tk" = (
/obj/structure/prop/urban/factory/robotic_arm,
/turf/open/floor/plating/ground/concrete,
/area/deathmatch)
"TH" = (
/obj/structure/prop/mainship/brokengen,
/turf/open/floor/plating/ground/concrete,
/area/deathmatch)
"TO" = (
/obj/structure/prop/urban/misc/fake/heavydutywire/heavy4{
	dir = 1
	},
/turf/open/floor/plating/ground/concrete,
/area/deathmatch)
"Uq" = (
/obj/effect/ai_node,
/obj/structure/barricade/solid/plasteel{
	dir = 8
	},
/obj/effect/mapping_helpers/barricade/melee,
/turf/open/floor/box,
/area/deathmatch)
"UX" = (
/turf/open/floor/urban/metal/grated,
/area/deathmatch)
"Wb" = (
/obj/structure/prop/urban/misc/fake/heavydutywire/heavy1{
	dir = 8
	},
/turf/open/floor/plating/ground/concrete,
/area/deathmatch)
"Xg" = (
/obj/structure/prop/urban/factory/robotic_arm/flipped,
/obj/structure/prop/urban/misc/fake/heavydutywire/heavy3{
	dir = 4
	},
/turf/open/floor/plating/ground/concrete,
/area/deathmatch)
"XH" = (
/obj/structure/prop/urban/vehicles/large/suv/suv_2,
/turf/open/floor/box,
/area/deathmatch)
"XP" = (
/obj/structure/prop/urban/factory/robotic_arm/flipped,
/obj/structure/prop/urban/misc/fake/heavydutywire/heavy4,
/turf/open/floor/plating/ground/concrete,
/area/deathmatch)
"Yk" = (
/obj/structure/prop/urban/misc/fake/heavydutywire/heavy3{
	dir = 1
	},
/turf/open/floor/plating/ground/concrete,
/area/deathmatch)
"Yx" = (
/obj/structure/prop/urban/misc/fake/wire,
/turf/open/floor/plating/ground/concrete,
/area/deathmatch)
"ZW" = (
/obj/effect/ai_node,
/obj/structure/barricade/solid/plasteel{
	dir = 4
	},
/obj/effect/mapping_helpers/barricade/melee,
/turf/open/floor/box,
/area/deathmatch)

(1,1,1) = {"
lq
lq
lq
lq
lq
lq
lq
lq
lq
lq
lq
lq
lq
lq
lq
lq
lq
lq
lq
lq
lq
lq
lq
lq
lq
lq
lq
lq
lq
lq
lq
lq
lq
lq
lq
lq
lq
lq
lq
lq
lq
lq
lq
lq
lq
lq
"}
(2,1,1) = {"
lq
lq
kW
iD
iD
iD
iD
iD
iD
iD
iD
iD
iD
iD
iD
iD
iD
kW
iD
iD
iD
iD
iD
iD
iD
iD
iD
iD
iD
iD
iD
iD
kW
IH
IH
IH
IH
IH
IH
IH
IH
IH
IH
IH
IH
lq
"}
(3,1,1) = {"
lq
lq
Ox
qZ
ez
Jg
qZ
ez
qZ
qZ
ez
qZ
Jg
ez
qZ
qZ
Yx
wE
Yx
qZ
qZ
ez
Jg
qZ
ez
qZ
qZ
ez
qZ
Jg
ez
qZ
Ht
IH
IH
IH
IH
IH
IH
IH
IH
IH
IH
IH
IH
lq
"}
(4,1,1) = {"
lq
lq
Ox
Yk
eX
eX
FE
rL
lN
rL
FE
XP
eX
XP
bL
Xg
Yx
wE
Yx
sC
bL
XP
eX
XP
FE
rL
lN
rL
FE
eX
eX
np
Ht
IH
IH
IH
IH
IH
IH
IH
IH
IH
IH
IH
IH
lq
"}
(5,1,1) = {"
lq
lq
Ox
TH
ez
ez
rL
zg
zg
zg
rL
Wb
ez
Wb
ez
Wb
Yx
wE
Yx
Wb
ez
Wb
ez
Wb
rL
zg
zg
zg
rL
ez
ez
TH
Ht
IH
IH
IH
IH
IH
IH
IH
IH
IH
IH
IH
IH
lq
"}
(6,1,1) = {"
lq
lq
Ox
ez
ez
jH
mF
zg
GX
zg
wi
zg
jH
zg
zg
Si
Si
UX
Si
Si
zg
zg
jH
zg
mF
zg
hH
zg
wi
jH
ez
ez
Ht
IH
IH
IH
IH
IH
IH
IH
IH
IH
IH
IH
IH
lq
"}
(7,1,1) = {"
lq
lq
Ox
ez
ez
zg
rL
zg
zg
zg
rL
ez
ez
ez
ez
ez
ez
wE
ez
ez
ez
ez
ez
ez
rL
zg
zg
zg
rL
zg
ez
ez
Ht
IH
IH
IH
IH
IH
IH
IH
IH
IH
IH
IH
IH
lq
"}
(8,1,1) = {"
lq
kW
LD
ez
ez
zg
ez
rL
Eq
rL
Ng
qZ
ez
qZ
ez
qZ
ez
wE
ez
qZ
ez
qZ
ez
qZ
Ng
rL
Eq
rL
ez
zg
ez
ez
Or
kW
IH
IH
IH
IH
IH
IH
IH
IH
IH
IH
IH
lq
"}
(9,1,1) = {"
lq
Ox
qZ
ez
ez
zg
ez
ez
ez
ez
ez
ez
ez
ez
ez
ez
ez
wE
ez
ez
ez
ez
ez
ez
ez
ez
ez
ez
ez
zg
ez
ez
qZ
Ht
IH
IH
IH
IH
IH
IH
IH
IH
IH
IH
IH
lq
"}
(10,1,1) = {"
lq
Ox
ez
rL
rL
DV
rL
rL
ez
ez
ez
ez
ez
ez
ez
ez
Yx
wE
Yx
ez
ez
ez
ez
ez
ez
ez
ez
rL
rL
DV
rL
rL
ez
Ht
IH
IH
IH
IH
IH
IH
IH
IH
IH
IH
IH
lq
"}
(11,1,1) = {"
lq
Ox
rL
vT
Km
Km
Km
sq
rL
ez
ez
BX
ez
XH
ez
zk
Yx
wE
Yx
uF
ez
Qd
ez
GY
ez
ez
rL
sq
Km
Km
Km
vT
rL
Ht
IH
IH
IH
IH
IH
IH
IH
IH
IH
IH
IH
lq
"}
(12,1,1) = {"
lq
Ox
rL
CB
Km
Km
Km
BI
rL
ez
ez
qZ
ez
qZ
ez
qZ
Yx
wE
Yx
qZ
ez
qZ
ez
qZ
ez
ez
rL
BI
Km
Km
Km
CB
rL
Ht
IH
IH
IH
IH
IH
IH
IH
IH
IH
IH
IH
lq
"}
(13,1,1) = {"
lq
Ox
ez
rL
rL
DV
rL
rL
ez
ez
ez
ez
ez
ez
ez
ez
Yx
wE
Yx
ez
ez
ez
ez
ez
ez
ez
ez
rL
rL
DV
rL
rL
ez
Ht
IH
IH
IH
IH
IH
IH
IH
IH
IH
IH
IH
lq
"}
(14,1,1) = {"
lq
Ox
qZ
ez
ez
zg
ez
ez
ez
ez
ez
ez
ez
ez
ez
ez
ez
wE
ez
ez
ez
ez
ez
ez
ez
ez
ez
ez
ez
zg
ez
ez
qZ
Ht
IH
IH
IH
IH
IH
IH
IH
IH
IH
IH
IH
lq
"}
(15,1,1) = {"
lq
kW
Eo
ez
ez
zg
ez
rL
wM
rL
Ng
qZ
ez
qZ
ez
qZ
ez
wE
ez
qZ
ez
qZ
ez
qZ
Ng
rL
wM
rL
ez
zg
ez
ez
SX
kW
IH
IH
IH
IH
IH
IH
IH
IH
IH
IH
IH
lq
"}
(16,1,1) = {"
lq
lq
Ox
ez
ez
zg
rL
zg
zg
zg
rL
ez
ez
ez
ez
ez
ez
wE
ez
ez
ez
ez
ez
ez
rL
zg
zg
zg
rL
zg
ez
ez
Ht
IH
IH
IH
IH
IH
IH
IH
IH
IH
IH
IH
IH
lq
"}
(17,1,1) = {"
lq
lq
Ox
ez
ez
jH
mF
zg
GX
zg
wi
zg
jH
zg
zg
Si
Si
UX
Si
Si
zg
zg
jH
zg
mF
zg
hH
zg
wi
jH
ez
ez
Ht
IH
IH
IH
IH
IH
IH
IH
IH
IH
IH
IH
IH
lq
"}
(18,1,1) = {"
lq
lq
Ox
TH
ez
ez
rL
zg
zg
zg
rL
Tk
ez
Tk
ez
Tk
Yx
wE
Yx
KT
ez
KT
ez
KT
rL
zg
zg
zg
rL
ez
ez
TH
Ht
IH
IH
IH
IH
IH
IH
IH
IH
IH
IH
IH
IH
lq
"}
(19,1,1) = {"
lq
lq
Ox
Pr
eX
eX
FE
rL
aZ
rL
FE
TO
eX
TO
bL
ib
Yx
wE
Yx
Pr
bL
TO
eX
TO
FE
rL
aZ
rL
FE
eX
eX
ib
Ht
IH
IH
IH
IH
IH
IH
IH
IH
IH
IH
IH
IH
lq
"}
(20,1,1) = {"
lq
lq
Ox
Jg
ez
Jg
qZ
ez
qZ
qZ
ez
qZ
Jg
ez
qZ
qZ
Yx
wE
Yx
lI
lI
Eq
ZW
lI
Eq
lI
lI
Eq
lI
ZW
Eq
Jg
Ht
IH
IH
IH
IH
IH
IH
IH
IH
IH
IH
IH
IH
lq
"}
(21,1,1) = {"
lq
lq
kW
Fj
HM
HM
HM
HM
HM
HM
HM
HM
HM
HM
HM
HM
Fj
kW
Fj
HM
HM
HM
HM
HM
HM
HM
HM
HM
HM
HM
HM
Fj
kW
IH
IH
IH
IH
IH
IH
IH
IH
IH
IH
IH
IH
lq
"}
(22,1,1) = {"
lq
lq
lq
zg
lq
lq
lq
lq
lq
lq
lq
lq
lq
lq
lq
lq
jH
lq
jH
zg
zg
zg
zg
zg
zg
zg
zg
zg
zg
jH
lq
zg
lq
IH
IH
IH
IH
IH
IH
IH
IH
IH
IH
IH
IH
lq
"}
(23,1,1) = {"
lq
IH
IH
jH
zg
zg
zg
zg
zg
zg
zg
zg
zg
zg
jH
lq
zg
lq
lq
lq
lq
lq
lq
lq
lq
lq
lq
lq
lq
zg
lq
jH
BV
zg
zg
zg
zg
zg
zg
zg
zg
BV
jH
IH
IH
lq
"}
(24,1,1) = {"
lq
IH
IH
jH
BV
zg
zg
zg
zg
zg
zg
zg
zg
BV
jH
lq
zg
lq
lq
lq
lq
lq
lq
lq
lq
lq
lq
lq
lq
zg
lq
jH
zg
zg
zg
zg
zg
zg
zg
zg
zg
zg
jH
IH
IH
lq
"}
(25,1,1) = {"
lq
IH
IH
IH
IH
IH
IH
IH
IH
IH
IH
IH
IH
lq
zg
lq
jH
zg
zg
zg
zg
zg
zg
zg
zg
zg
zg
jH
lq
jH
lq
lq
lq
lq
lq
lq
lq
lq
lq
lq
lq
lq
zg
lq
lq
lq
"}
(26,1,1) = {"
lq
IH
IH
IH
IH
IH
IH
IH
IH
IH
IH
IH
IH
kW
xY
iD
iD
iD
iD
iD
iD
iD
iD
iD
iD
iD
iD
xY
kW
xY
iD
iD
iD
iD
iD
iD
iD
iD
iD
iD
iD
iD
xY
kW
lq
lq
"}
(27,1,1) = {"
lq
IH
IH
IH
IH
IH
IH
IH
IH
IH
IH
IH
IH
Ox
Jg
wM
Uq
Ii
wM
Ii
Ii
wM
Ii
Uq
wM
Ii
Ii
Yx
wE
Yx
qZ
qZ
ez
Jg
qZ
ez
qZ
qZ
ez
qZ
Jg
ez
Jg
Ht
lq
lq
"}
(28,1,1) = {"
lq
IH
IH
IH
IH
IH
IH
IH
IH
IH
IH
IH
IH
Ox
Yk
eX
eX
FE
rL
lN
rL
FE
XP
eX
XP
bL
Xg
Yx
wE
Yx
sC
bL
XP
eX
XP
FE
rL
lN
rL
FE
eX
eX
np
Ht
lq
lq
"}
(29,1,1) = {"
lq
IH
IH
IH
IH
IH
IH
IH
IH
IH
IH
IH
IH
Ox
TH
ez
ez
rL
zg
zg
zg
rL
Wb
ez
Wb
ez
Wb
Yx
wE
Yx
Wb
ez
Wb
ez
Wb
rL
zg
zg
zg
rL
ez
ez
TH
Ht
lq
lq
"}
(30,1,1) = {"
lq
IH
IH
IH
IH
IH
IH
IH
IH
IH
IH
IH
IH
Ox
ez
ez
jH
mF
zg
GX
zg
wi
zg
jH
zg
zg
Si
Si
UX
Si
Si
zg
zg
jH
zg
mF
zg
hH
zg
wi
jH
ez
ez
Ht
lq
lq
"}
(31,1,1) = {"
lq
IH
IH
IH
IH
IH
IH
IH
IH
IH
IH
IH
IH
Ox
ez
ez
zg
rL
zg
zg
zg
rL
ez
ez
ez
ez
ez
ez
wE
ez
ez
ez
ez
ez
ez
rL
zg
zg
zg
rL
zg
ez
ez
Ht
lq
lq
"}
(32,1,1) = {"
lq
IH
IH
IH
IH
IH
IH
IH
IH
IH
IH
IH
kW
LD
ez
ez
zg
ez
rL
Eq
rL
Ng
qZ
ez
qZ
ez
qZ
ez
wE
ez
qZ
ez
qZ
ez
qZ
Ng
rL
Eq
rL
ez
zg
ez
ez
Or
kW
lq
"}
(33,1,1) = {"
lq
IH
IH
IH
IH
IH
IH
IH
IH
IH
IH
IH
Ox
qZ
ez
ez
zg
ez
ez
ez
ez
ez
ez
ez
ez
ez
ez
ez
wE
ez
ez
ez
ez
ez
ez
ez
ez
ez
ez
ez
zg
ez
ez
qZ
Ht
lq
"}
(34,1,1) = {"
lq
IH
IH
IH
IH
IH
IH
IH
IH
IH
IH
IH
Ox
ez
rL
rL
DV
rL
rL
ez
ez
ez
ez
ez
ez
ez
ez
Yx
wE
Yx
ez
ez
ez
ez
ez
ez
ez
ez
rL
rL
DV
rL
rL
ez
Ht
lq
"}
(35,1,1) = {"
lq
IH
IH
IH
IH
IH
IH
IH
IH
IH
IH
IH
Ox
rL
vT
Km
Km
Km
sq
rL
ez
ez
BX
ez
XH
ez
zk
Yx
wE
Yx
uF
ez
Qd
ez
GY
ez
ez
rL
sq
Km
Km
Km
vT
rL
Ht
lq
"}
(36,1,1) = {"
lq
IH
IH
IH
IH
IH
IH
IH
IH
IH
IH
IH
Ox
rL
CB
Km
Km
Km
BI
rL
ez
ez
qZ
ez
qZ
ez
qZ
Yx
wE
Yx
qZ
ez
qZ
ez
qZ
ez
ez
rL
BI
Km
Km
Km
CB
rL
Ht
lq
"}
(37,1,1) = {"
lq
IH
IH
IH
IH
IH
IH
IH
IH
IH
IH
IH
Ox
ez
rL
rL
DV
rL
rL
ez
ez
ez
ez
ez
ez
ez
ez
Yx
wE
Yx
ez
ez
ez
ez
ez
ez
ez
ez
rL
rL
DV
rL
rL
ez
Ht
lq
"}
(38,1,1) = {"
lq
IH
IH
IH
IH
IH
IH
IH
IH
IH
IH
IH
Ox
qZ
ez
ez
zg
ez
ez
ez
ez
ez
ez
ez
ez
ez
ez
ez
wE
ez
ez
ez
ez
ez
ez
ez
ez
ez
ez
ez
zg
ez
ez
qZ
Ht
lq
"}
(39,1,1) = {"
lq
IH
IH
IH
IH
IH
IH
IH
IH
IH
IH
IH
kW
Eo
ez
ez
zg
ez
rL
wM
rL
Ng
qZ
ez
qZ
ez
qZ
ez
wE
ez
qZ
ez
qZ
ez
qZ
Ng
rL
wM
rL
ez
zg
ez
ez
SX
kW
lq
"}
(40,1,1) = {"
lq
IH
IH
IH
IH
IH
IH
IH
IH
IH
IH
IH
IH
Ox
ez
ez
zg
rL
zg
zg
zg
rL
ez
ez
ez
ez
ez
ez
wE
ez
ez
ez
ez
ez
ez
rL
zg
zg
zg
rL
zg
ez
ez
Ht
lq
lq
"}
(41,1,1) = {"
lq
IH
IH
IH
IH
IH
IH
IH
IH
IH
IH
IH
IH
Ox
ez
ez
jH
mF
zg
GX
zg
wi
zg
jH
zg
zg
Si
Si
UX
Si
Si
zg
zg
jH
zg
mF
zg
hH
zg
wi
jH
ez
ez
Ht
lq
lq
"}
(42,1,1) = {"
lq
IH
IH
IH
IH
IH
IH
IH
IH
IH
IH
IH
IH
Ox
TH
ez
ez
rL
zg
zg
zg
rL
Tk
ez
Tk
ez
Tk
Yx
wE
Yx
KT
ez
KT
ez
KT
rL
zg
zg
zg
rL
ez
ez
TH
Ht
lq
lq
"}
(43,1,1) = {"
lq
IH
IH
IH
IH
IH
IH
IH
IH
IH
IH
IH
IH
Ox
Pr
eX
eX
FE
rL
aZ
rL
FE
TO
eX
TO
bL
ib
Yx
wE
Yx
Pr
bL
TO
eX
TO
FE
rL
aZ
rL
FE
eX
eX
ib
Ht
lq
lq
"}
(44,1,1) = {"
lq
IH
IH
IH
IH
IH
IH
IH
IH
IH
IH
IH
IH
Ox
qZ
ez
Jg
qZ
ez
qZ
qZ
ez
qZ
Jg
ez
qZ
qZ
Yx
wE
Yx
qZ
qZ
ez
Jg
qZ
ez
qZ
qZ
ez
qZ
Jg
ez
qZ
Ht
lq
lq
"}
(45,1,1) = {"
lq
IH
IH
IH
IH
IH
IH
IH
IH
IH
IH
IH
IH
kW
HM
HM
HM
HM
HM
HM
HM
HM
HM
HM
HM
HM
HM
HM
kW
HM
HM
HM
HM
HM
HM
HM
HM
HM
HM
HM
HM
HM
HM
kW
lq
lq
"}
(46,1,1) = {"
lq
lq
lq
lq
lq
lq
lq
lq
lq
lq
lq
lq
lq
lq
lq
lq
lq
lq
lq
lq
lq
lq
lq
lq
lq
lq
lq
lq
lq
lq
lq
lq
lq
lq
lq
lq
lq
lq
lq
lq
lq
lq
lq
lq
lq
lq
"}
